111111111111
1C0CC11C1111
10110010E001
10A101010001
101010010011
100C00000P01
100000000001
111111111111