1111111111111111111111
1110111111110100110111
100000C0C01110C0101011
100100C00C0C100C000C01
1010100000A011000C0001
10000E0001000000010101
100100100000C010000001
1000000000000000P00001
1010000000000000000001
1000000100000000000001
1000000000000000000001
1111111111111111111111