111111111111
1E0100000101
10C1CCC0C001
100C1C0C0011
1CC0C1C10011
100000000101
10C010101011
1C0C000C0001
1C0C001001C1
11000C011001
1000100C00C1
110000110001
101001000001
10000CAC0001
10C0000CC001
10001001P101
100010000001
100C000011C1
101000000011
1C00010C0001
101000000001
10000C000001
10000001C001
100000000001
100C00000001
100000000001
100000C00001
10010C000001
100000000001
100000100001
10000000C001
1C0000000001
100000000001
10000000C001
100000000001
100000000001
100000000001
100100000001
100000000001
100000000001
100000000001
100000000001
100000000001
100000000001
100000000001
100000000001
100000000001
100000000001
100000000001
111111111111