1111111111111111111111111111111111111111111111111111111111111111111111
10000000P000000000010C000000000000000000000C00000000C00000C00000000CC1
10C0000000010000000000000000000000C000000000000000000000C0100000000001
100000000000000000000000000000000000000000000000010000C000000000000C01
10010000000000000000000E000000000000000000000000C000010000000000000001
10000000000000000C00000000000000000000000A0000000000000000000000000001
100000000000C000000000000000000000000000000000000000000000000000000001
1111111111111111111111111111111111111111111111111111111111111111111111