1111111111
1C1CC01P11
10C01C1001
100E100C01
1000100011
10000A1001
1000000001
1000010C01
1000000001
1000000001
1000000001
1111111111