1111111111
1101110E01
1010100001
100P000101
1001000001
1000000001
1000000001
10000C0101
1000100001
1000000001
1000000001
1111111111
