1111111111
11000100A1
1010000011
1001100101
1000P00011
1000000001
10E0000001
1000010101
1000000001
1000000001
1000000001
1111111111
