1111111111
1C111111C1
10100010C1
100C000C01
100PC00011
10A0000001
1010000001
1000000C01
1000000001
1000000001
1000000001
1111111111
