1111111111
1100110011
10000E0011
100C100001
1001100011
100000P001
1010000001
10000A0001
1000000001
1000000001
1000000001
1111111111
