1111111111
11010C1111
1010PA0011
1001000001
1000000001
100001E001
1010000001
1000000001
1000000001
1111111111
