1111111111
1EA0111101
1010100011
1001000001
100C000001
10000P1001
1111111111
100C000001
1111111111
