NO ./textures/walls/brick_red.xpm
SO ./textures/walls/brick_white.xpm
WE ./textures/walls/cinderblock.xpm
EA ./textures/walls/roof_brick.xpm

F 220, 100, 9
C 225, 30, 144

1111111111111
1]00000000001
1000001000001
1000000000001
1000001000001
1000000000001
1000000000001111111111111111111111111111111111111111111111111111
1000001000001+00000000000000000[111111000000000DDDDD000000000001
1000000000001000000001000010000111111100000000000D00000000000001
100000000000K0N0000000000000000000000000000000000000000000000001
1111000000001000000000000000000000000000000011111100000000000001
1111}000000010000000000000000000000000000000111111{0000000000001
1111111111111111111111111111111111111111111111111111111111111111