EA ./textures/walls/roof_brick.xpm      
WE ./textures/walls/cinderblock.xpm     
SO ./textures/walls/brick_white.xpm
NO ./textures/walls/brick_red.xpm


     

F 20,            100, 100
C 225, 30, 144   


1111111111
1N00000001
1000000001
1000000001
1111111111
