      NO 				  			 ./textures/walls/brick_red.xpm
 SO ./textures/walls/brick_white.xpm
    WE ./textures/walls/cinderblock.xpm 
	EA ./textures/walls/roof_brick.xpm

 F	0	  	,	    128,	 255	 
 C	128	 	 ,	  		128,	 128


11111111111111111111111111111111111111
100000000000000000000000000000000000{1
10000000000000000000000000000000000011
10000000000000000000000000000000000001
10000000000000000000000000000000000001
10000000000000000000000000000000000001
100001K1111111111111111110000000000001
10000100111111100000000010000000000001
100001000011111K1111111110000000000001111111111111111111111111111111
10000100000000000010000010000000000001000000000000000000000000000001
100001000000000000K0000010000000000001000000000000000000000000000001
100001K1K1K1K1K1K110000010000000000001000011111110000000111111100001
10000101010101010110000010000000000001000000000000000000000000000001
10000111111111111111111110000000000001000011111110000000111111100001
1000010000000000000000001000000000000K000000000000000000000000000001
10000100001111111110000010000000000001000000000000000000000000000001
100001000000000000000000K000000000000100000000000000]000000000000001
11K1111111111111111111111111K1111111111111111111111111111111K111111111111
10000000000000000000000000000001                10000000000000000001+0P01
10000001111111111111111000000001                1000000000000000000100001
10000000000000000000000000000001                1000000000000000000100001
10000001111111111111111000000001                1000000000000000000K00N01
10000000000000000000000000000001                1000000000000000000100001
1000000111111111111111100000000111111111111111111000000000000000000100001
1000000000000000000000000000000000000000000000001000000000000000000111111
100000000000000000000000000000000000000000000000K000000000000000000000001
1000000000000000000000000000000000000000000000001000000000000000000000001
1000000111111111111111100000000111111111111111111000000000000000000000001111111111
10000000000000000000000000000001                100000000000000000000000K000000001
10000001111111111111111000000001                1000000000000000000000001000111001
10000000000000000000000000000001                1000000000000000000000001000000001
1000000111111111111111100000000111111111111111111111111111K11111000000001000111111
1000000000000000000000000000000000000000000000000000000000000001000000001000000001
10000001111111111111111000000000000000000000000000000000000000010000000010000000}1
1000000000000000000000000000000100010001000100010000000000000001111111111111111111
1000000111111111111111100000000100010001000100010000000000000001
1000000000000000000000000000000100010001000100010000000000000001
1000000111111111111111100000000100010001000100010000000000000001
1000000000000000000000000000000100010001000100010000000000000001111111111
1000000111111111111111100000000100010001000100010000000000000000000000001
1000000000000000000000000000000000000000000000000000000000000000000100001
1[00000000000000000000000000000000000000000000000000000000000000000000001
1111111111111111111111111111111111111111111111111111111111111111111111111